video 1 : Learn Pronouns in an easy way. Learn your basics perfectly.

Personal Pronouns                     singular : plural
first person : speaker                 I     :  we
seconf person : listener                you : you
third person : the one we are talking   he/she/it : they/them

subject Pronouns  :
he she it I you we they

Object Pronouns  :
me, you, us, them, him, her, it
--------------------------------------------
video 2 : గుర్తుచేయటం, గుర్తు పట్టటం and some more words in English.

remember : gurtupetukovadam  Ex: 
recollect : gurtutechukovadam  Ex:wait a minute let me recollect it 
Remaind : gurtucheyadam Ex: please remaind me that i have a meeting tommorrow
Recognize  : gurtupattadam Ex: i am not able to Recognize the person , i am not able to recognize who u r
----------------------------------------
video 3 : Different types of rains, very important to talk about weather.

it's raining : varasham padutundi 
it's pouring : kundapa varsham padutundi
it's drizzling : vana tupara padutundi
draought : karuvu Ex. anamthapur is facing severe draought
Floods : varadalu Ex. floods swept away all the houses
Hail storm : vadagalu,  ices padutay
--------------------------------------------
video 4 : Learn the names of some celebrations in English.

Ceremonies" can be translated as ఆచారాలు (aachaaralu), ఉత్సవాలు (utsavalu), or కర్మకాండలు

annaprasana : weaning ceremony Ex. you have to attend my son's weamony next week
barasala : cradle ceremony     Ex. thanks for attending my son's cradle
namakarna : naming ceremony    Ex. i invited every body for my son's naming ceremony
baby shower : srimantham      i will buy a sare for my sister baby shower
house warming : gruhapravesham dont say house opening
----------------------------------------------
video 5: words to talk about Cooking || Learn cooking vocabulary in English

pindhi  పిండి  : batter
dosa pindhi : dosa batter
pulva pettadani : ferment 
chapathi kalipina pindhi ni  : dough anali
roll : vedalupu gaa chestam chappatini
knead : cheppatini tayaruchesdapudu hands tho table ki antham dani knead anali
jalidi pattadani : sieve 
sieve" translates to "జల్లెడ" (jalleda).
Flip:tipadam Ex. Flip dosa on padutundi
Bake : cakes, cookies cheyadam
Greese : oil apply chese process, ex. greece the pan before make a dosa on it
Pour : poyadam, liquid gaa unavatini imko dantlo posedapudu vadutam
                        Ex. pour the idle batter into the bowl
---------------------------------------------------------
video 6: Learn these words to talk about Cooking easily || cooking vocabulary in English

burn : madipovadam Ex. Rice is burn
boil over : pallu pongi poyayi
Beat : visk cheyadam mix ayela cheyadam
churn : magika chilakadam
Dip : munchadam dentloayina
Drain : water motham velipoyala cheyadam ex. vanchadam 
filter : vadagatadam
freeze : gadha katinchadam
Garnish : food ni onions/kothimera tho decorate cheydani Garnish anali
Measure: kolavadam ante half cup measure chesi oil alla anamata
---------------------------------------------------------
video 7: 


